#########*##########
#*****###*##***#***#
#*###*###*##*#***#*#
#*###********###*#*#
#*###*###*##*###*#*#
#*****###********#*#
#*###*######*###*#*#
#*###****###*###*#*#
#*****##*###*******#
###*###**#######*###
#*****#*####*******#
#*###*#*####*###*#*#
#*###***####*###*#*#
#*###*#*####*###*#*#
#*****#**********#*#
#*###*###*##*###*#*#
#*###********###*#*#
#*###*###*##*#***#*#
#*****###*##***#***#
#########*##########